NO ./assets/colorstone.xpm
SO ./assets/eagle.xpm
WE ./assets/mossy.xpm
EA ./assets/greystone.xpm
F 105,105,105
C 25,25,112

11111111111111111
11110000000001111
11110000000001111
11110000000001111
11110000000001111
10000000000000001
10000000000000001
10000000000000001
10000000N00000001
10000000000000001
10000000000000001
11111111111111111