NO ./assets/colorstone.xpm
SO ./assets/eagle.xpm
WE ./assets/mossy.xpm
EA ./assets/greystone.xpm

F 220,100,0
C 225,30,0

111111111111111111111111111111111111111111111111111111111111111111111111111111111111111111111111111111111111111111111111111111111111111111111111111111
111111111111111111111111111111111111111111111111111111111111111111111111111111111111111111111111111111111111111111111111111111111111111111111111111111
111111111111111111111111111111111111111111111111111111111111111111111111111111111111111111111111111111111111111111111111111111111111111111111111111111
111111111111111111111111111111111111111111111111111111111111111111111111111111111111111111111111111111111111111111111111111111111111111111111111111111
111111111111111111111111111111111111111111111111111111111111111111111111111111111111111111111111111111111111111111111111111111111111111111111111111111
111111111111111111111111111111111111111111111111111111111111111111111111111111111111111111111111111111111111111111111111111111111111111111111111111111
111111111111111111111111111111111111111111111111111111111111111111111111111111111111111111111111111111111111111111111111111111111111111111111111111111
111111111111111111111111111111111111111111111111111111111111111111111111111111111111111111111111111111111111111111111111111111111111111111111111111111
111111111111111111111111111111111111111111111111111111111111111111111111111111111111111111111111111111111111111111111111111111111111111111111111111111
111111111111111111111111111111111111111111111111111111111111111111111111111111111111111111111111111111111111111111111111111111111111111111111111111111
111111111111111111111111111111111111111111111111111111111111111111111111111111111111111111111111111111111111111111111111111111111111111111111111111111
11111111111111111111111111111111111111111111111111111111111111111111111111111111111111111111111111111111111111111111111111111111111111111111
111111111111111111111111111111111111111111111111111111111111111111111111111111111111111111111111111111111111111111111111111111111111
11111111111111111111111111111111111111111111111111111111111111111111111111111111111111111111111111111111111111111111111111111111111
111111111111111111111111111111111111111111111111111111111111111111111111111111111111111111111111111111
11111111111111111111111111111111000000000001111111111111111111111111111111111111111111111111111
11111111111111111111101111111111111111111111111111111111111111111111111111
11111111111111111111111111111111000111111111111111110000001111111111111111111111111111111111
1111111111111110100011111111100000000011111111111111111111111111111
111111111111100000000000001111111000000000000000000001111111111111111111111111
111111111111100000000000111111100000000000000000000000000000011111111111111111111111
11111111111110000000000000001100111110000000000000000000000000000000000000111111111111111111111111
1111111110000000000000111011111111100000000000000000000000000000000000011111111111111111111111111
11111111111110000000000001110111111111000000000000000000000000000000000001111111111111111111111111111
1111111111111000000000000111111111111111000000000000000000000000000000000001111011111111111111111111111111
11111111111111100000000000000000111111111111000000000000000000000000000000000001111111111111111111111111111
111111111111111000000000000000111111111111000000000000000000000000000000000000000000111111111111111111111111111
111111111111111111100000000000000011111111111111000000000000000000000000000000000000001111111111111111111111111111
1111111111111111111000000000000011111111111111000000000000000000000000000000000011111111111111111111111111111
11111111111111111110000000000000000111111111111111111000000000000000000000000000000111111111111111111111111111
1111111111111111110000000000000000011111111111111110001000000000000000000000000000011111111111111111111111111111
11111111111111110000000000000011111111111111111110000000000000000000000000111111111111111111111111111111
11111111111111111000000000000111111111111111111110010000000000000000000000000111111111111111111111111111111
111111111111111110000000000000011111111111111111111111000000000000000000000000011111111111111111111111111111
1111111111111111110000000001111111111111111111111000011110000000000000000000000000000111111111111111111111111111111
111111111111111111100000000111111111111111111111110000000000000000000N00000000001111111111111111111111111111111111
11111111111111111100001111111111111111111111100000000000000000000000000000000000000011111111111111111111111111111111
111111111111111111101111111111111111111111111110000000000000000000000000001111111111111111111111111111111111
11111111111111111110011111111111111111111110000000000000000000000000000000111111111111111111111111111111111
111111111111111111101111111111111111111110000000000000000011000000000000111111111111111111111111111111111
1111111111111111111111101111111111111111111110000000000000000000001000001111111111111111111111111111111111111
111111111111111111111001111111111111111110000000000000000000100110001111111111111111111111111111111111
1111111111111111111111101111111111111111100000000000000000000111011111111111111111111111111111111111
1111111111111111111111111011111111111111111111110000000000000000000011111101100011111111111111111111111111111111
11111111111111111111111111111111111111111111111100000000000000000000011111100111111111111111111111111111111111
111111111111111111111111111111111111111110000000000000011111110111111111111111111111111111111111
11111111111111111111111111111100000111111111111111110000000000000000000011111111111111111111111111111111111111111111
111111111111111111111111111111100111111111110000000000000000111111111111111111111111111111111111111111111
1111111111111111111111111111111100000000111111111111111000000000000111111111111111111111111111111111111111111111
111111111111111111111111111111000000011111111111111111000000000001111111111111111101111111111111111111111111111
1111111111111111111111111111100000000011111111111110000000001111111111111111110100111111111111111111111111
1111111111111111111111111111100000000000111111111111111111000000000111111111111111111111111111111111111111111
1111111111111111111111111111111000000000000001111111111111110000000011111111111111111111111011111111111111111111
11111111111111111111111111111110000000000001111111111111110000000111111111111111111111110111111111111111111
1111111111111111111111111111111100000000000000111111111111111100000001111111111111111111111111111111111111111111
111111111111111111111111111111100000000000011111111111111111000000011111111111111111111111111111111111111111111111
11111111111111111111111111111111100000000001111111111111111100000001111111111111111111111111011111111111111111111111
1111111111111111111111111111111100000000000011111111111111110000000011111111111111111111111111111111111111
1111111111111111111111111111111111110000000111111111111111110000000101111111111111111111111111100000111111111111111111
1111111111111111111111111111111111100000000111111111111111111000111111111111111111111111110000111111111111111111
111111111111111111111111111111111110000000001111111111111111110000011111111111111111111111000000001111111111111111
11111111111111111111111111111111111100000111111111111111111110001111111111111111111111000000000001111111111111111111111
111111111111111111111111111111111111000001111111111111111111111000111111111111111111111111100000000111111111111111111111
1111111111111111111111111111111111110000001111111111111111111100011111111111111111111111111111000000001111111111111111111111
111111111111111111111111111111111111000011111111111111111111111011111111111111111111111111000000000011111111111111111111
1111111111111111111111111111111111110000111111111111111111111110011111111111111111111111111111100011111111111111111111111
11111111111111111111111111111111111101111111111111111111111111111111111111111111111111111111111101111111111111111111
11111111111111111111111111111111111100011111111111111111111111111111111111111111111111111111111111111111110111111111111111111
111111111111111111111111111111111111011111111111111111111111111111111111111111111111111111111111111111111111111111111111
11111111111111111111111111111111111111111111111111111111111111111111111111111111111111111111111111111111111111111111111111111111111111
11111111111111111111111111111111111101111111111111111111111111111111111111111111111111111111111111111111111111111111111111111111111
111111111111111111111111111111111111101111111111111111111111111111111111111111111111111111111111111111111111111111111111111111111111
111111111111111111111111111111111111111111111111111111111111111111111111111111111111111111111111111111111111111111111111111111111111111111
1111111111111111111111111111111111111011111111111111111111111111111111111111111111111111111111111111111111111111111111111111111111111111111
11111111111111111111111111111111111111011111111111111111111111111111111111111111111111111111111111111111111111111111111111111111111111111111
111111111111111111111111111111111111111111111111111111111111111111111111111111111111111111111111111111111111111111111111111111111111111111111111
1111111111111111111111111111111111111111111111111111111111111111111111111111111111111111111111111111111111111111111111111111111111111111111111111
1111111111111111111111111111111111111111111111111111111111111111111111111111111111111111111111111111111111111111111111111111111111111111111111111111
11111111111111111111111111111111111111111111111111111111111111111111111111111111111111111111111111111111111111111111111111111111111111111111111111111
111111111111111111111111111111111111111111111111111111111111111111111111111111111111111111111111111111111111111111111111111111111111111111111111111111
111111111111111111111111111111111111111111111111111111111111111111111111111111111111111111111111111111111111111111111111111111111111111111111111111111
111111111111111111111111111111111111111111111111111111111111111111111111111111111111111111111111111111111111111111111111111111111111111111111111111111
111111111111111111111111111111111111111111111111111111111111111111111111111111111111111111111111111111111111111111111111111111111111111111111111111111
111111111111111111111111111111111111111111111111111111111111111111111111111111111111111111111111111111111111111111111111111111111111111111111111111111
111111111111111111111111111111111111111111111111111111111111111111111111111111111111111111111111111111111111111111111111111111111111111111111111111111
111111111111111111111111111111111111111111111111111111111111111111111111111111111111111111111111111111111111111111111111111111111111111111111111111111
111111111111111111111111111111111111111111111111111111111111111111111111111111111111111111111111111111111111111111111111111111111111111111111111111111
111111111111111111111111111111111111111111111111111111111111111111111111111111111111111111111111111111111111111111111111111111111111111111111111111111
111111111111111111111111111111111111111111111111111111111111111111111111111111111111111111111111111111111111111111111111111111111111111111111111111111
111111111111111111111111111111111111111111111111111111111111111111111111111111111111111111111111111111111111111111111111111111111111111111111111111111
